estaca;Area;Esfuerzo;size;distancia;m;c
1;35;1;1;14;1;0
1;35;1;1;15;1;0
1;35;1;2;16;2;0
1;35;1;1;17;1;0
1;35;1;3;18;3;0
1;35;1;3;19;3;0
1;35;1;2;20;2;0
2;35;1;2;1;0;2
2;35;1;2;2;2;0
2;35;1;8;3;1;7
2;35;1;7;4;2;5
2;35;1;6;5;2;4
2;35;1;9;6;6;3
2;35;1;13;7;9;4
2;35;1;8;8;7;1
2;35;1;17;9;9;8
2;35;1;15;10;8;7
2;35;1;10;11;3;7
2;35;1;8;12;3;5
2;35;1;3;13;1;2
2;35;1;2;14;2;0
2;35;1;5;15;4;1
2;35;1;3;16;3;0
2;35;1;7;17;4;3
2;35;1;11;18;10;1
2;35;1;19;19;18;1
2;35;1;21;20;15;6
3;35;1;2;3;0;2
3;35;1;5;5;0;5
3;35;1;10;6;4;6
3;35;1;11;7;3;8
3;35;1;12;8;2;10
3;35;1;19;9;7;12
3;35;1;15;10;6;9
3;35;1;18;11;7;11
3;35;1;29;12;21;8
3;35;1;18;13;12;6
3;35;1;14;14;7;7
3;35;1;15;15;5;10
3;35;1;13;16;5;8
3;35;1;5;17;1;4
3;35;1;13;18;8;5
3;35;1;19;19;12;7
3;35;1;29;20;20;9
4;35;1;4;4;0;4
4;35;1;2;5;1;1
4;35;1;2;6;0;2
4;35;1;2;7;2;0
4;35;1;8;8;0;8
4;35;1;3;9;1;2
4;35;1;11;10;4;7
4;35;1;7;11;4;3
4;35;1;5;12;0;5
4;35;1;6;13;2;4
4;35;1;14;14;4;10
4;35;1;6;15;1;5
4;35;1;7;16;3;4
4;35;1;4;17;2;2
4;35;1;10;18;3;7
4;35;1;4;19;3;1
4;35;1;16;20;6;10
5;35;1;1;5;1;0
5;35;1;4;6;3;1
5;35;1;3;7;1;2
5;35;1;6;8;3;3
5;35;1;8;9;5;3
5;35;1;10;10;6;4
5;35;1;6;11;4;2
5;35;1;4;12;4;0
5;35;1;4;14;3;1
5;35;1;3;15;1;2
5;35;1;6;16;5;1
5;35;1;12;17;12;0
5;35;1;22;18;20;2
5;35;1;11;19;11;0
5;35;1;15;20;15;0
6;35;1;2;1;2;0
6;35;1;4;2;4;0
6;35;1;4;3;4;0
6;35;1;4;4;3;1
6;35;1;6;5;4;2
6;35;1;7;6;6;1
6;35;1;2;7;2;0
6;35;1;12;8;11;1
6;35;1;7;9;3;4
6;35;1;3;10;3;0
6;35;1;5;11;5;0
6;35;1;18;12;18;0
6;35;1;8;13;4;4
6;35;1;5;14;1;4
6;35;1;7;15;2;5
6;35;1;4;16;2;2
6;35;1;5;17;5;0
6;35;1;5;18;3;2
6;35;1;3;19;2;1
6;35;1;19;20;11;8
7;35;1;1;2;0;1
7;35;1;4;3;3;1
7;35;1;17;4;15;2
7;35;1;20;5;18;2
7;35;1;11;6;4;7
7;35;1;16;7;16;0
7;35;1;14;8;11;3
7;35;1;11;9;9;2
7;35;1;15;10;11;4
7;35;1;9;11;6;3
7;35;1;14;12;12;2
7;35;1;16;13;15;1
7;35;1;15;14;13;2
7;35;1;8;15;4;4
7;35;1;11;16;7;4
7;35;1;10;17;10;0
7;35;1;9;18;8;1
7;35;1;12;19;10;2
7;35;1;15;20;12;3
8;35;1;1;3;0;1
8;35;1;1;6;0;1
8;35;1;1;7;0;1
8;35;1;1;8;0;1
8;35;1;2;9;0;2
8;35;1;1;10;0;1
8;35;1;3;11;0;3
8;35;1;1;12;0;1
8;35;1;1;13;0;1
8;35;1;3;14;0;3
8;35;1;5;15;0;5
8;35;1;5;16;1;4
8;35;1;2;17;2;0
8;35;1;9;18;5;4
8;35;1;7;19;5;2
8;35;1;22;20;6;16
9;35;1;3;1;3;0
9;35;1;1;3;1;0
9;35;1;3;4;3;0
9;35;1;3;5;3;0
9;35;1;3;6;3;0
9;35;1;1;9;1;0
9;35;1;5;10;5;0
9;35;1;2;11;2;0
9;35;1;3;12;3;0
9;35;1;2;13;2;0
9;35;1;4;14;4;0
9;35;1;7;15;7;0
9;35;1;2;16;2;0
9;35;1;2;17;2;0
9;35;1;4;18;4;0
9;35;1;4;19;4;0
9;35;1;9;20;9;0
10;35;1;2;1;2;0
10;35;1;6;5;6;0
10;35;1;6;6;5;1
10;35;1;8;7;6;2
10;35;1;7;8;5;2
10;35;1;2;9;2;0
10;35;1;6;10;3;3
10;35;1;4;11;3;1
10;35;1;3;12;1;2
10;35;1;2;13;1;1
10;35;1;9;14;7;2
10;35;1;3;15;0;3
10;35;1;1;16;0;1
10;35;1;5;17;3;2
10;35;1;11;18;9;2
10;35;1;7;19;6;1
10;35;1;13;20;8;5
11;35;1;2;2;1;1
11;35;1;6;3;4;2
11;35;1;13;4;10;3
11;35;1;8;5;7;1
11;35;1;11;6;6;5
11;35;1;10;7;10;0
11;35;1;13;8;3;10
11;35;1;10;9;7;3
11;35;1;11;10;10;1
11;35;1;8;11;5;3
11;35;1;7;12;5;2
11;35;1;4;13;3;1
11;35;1;5;14;0;5
11;35;1;7;15;6;1
11;35;1;6;16;3;3
11;35;1;4;17;3;1
11;35;1;5;18;4;1
11;35;1;5;19;1;4
11;35;1;17;20;13;4
12;35;1;11;1;11;0
12;35;1;4;2;4;0
12;35;1;9;3;9;0
12;35;1;9;4;9;0
12;35;1;2;5;2;0
12;35;1;11;6;11;0
12;35;1;12;7;12;0
12;35;1;7;8;6;1
12;35;1;7;9;7;0
12;35;1;10;10;10;0
12;35;1;6;11;6;0
12;35;1;3;12;3;0
12;35;1;10;13;10;0
12;35;1;5;14;5;0
12;35;1;6;15;6;0
12;35;1;14;16;14;0
12;35;1;11;17;11;0
12;35;1;11;18;11;0
12;35;1;6;19;6;0
12;35;1;5;20;5;0
13;35;1;4;2;1;3
13;35;1;5;3;0;5
13;35;1;4;4;1;3
13;35;1;6;5;0;6
13;35;1;8;6;1;7
13;35;1;7;7;0;7
13;35;1;7;8;0;7
13;35;1;7;9;1;6
13;35;1;14;10;0;14
13;35;1;13;11;0;13
13;35;1;11;12;1;10
13;35;1;13;13;1;12
13;35;1;13;14;0;13
13;35;1;10;15;0;10
13;35;1;5;16;1;4
13;35;1;12;17;1;11
13;35;1;8;18;0;8
13;35;1;7;19;0;7
13;35;1;7;20;0;7
14;35;1;4;2;4;0
14;35;1;3;3;3;0
14;35;1;4;4;4;0
14;35;1;3;5;3;0
14;35;1;5;6;5;0
14;35;1;8;7;8;0
14;35;1;14;8;14;0
14;35;1;8;9;8;0
14;35;1;14;10;14;0
14;35;1;6;11;4;2
14;35;1;7;12;7;0
14;35;1;17;13;16;1
14;35;1;15;14;15;0
14;35;1;9;15;9;0
14;35;1;9;16;8;1
14;35;1;12;17;12;0
14;35;1;18;18;17;1
14;35;1;17;19;17;0
14;35;1;21;20;21;0
15;35;1;2;3;0;2
15;35;1;3;4;2;1
15;35;1;9;5;4;5
15;35;1;5;6;3;2
15;35;1;8;7;5;3
15;35;1;13;8;11;2
15;35;1;15;9;12;3
15;35;1;10;10;8;2
15;35;1;7;11;2;5
15;35;1;9;12;4;5
15;35;1;9;13;7;2
15;35;1;9;14;5;4
15;35;1;12;15;7;5
15;35;1;4;16;3;1
15;35;1;9;17;6;3
15;35;1;15;18;11;4
15;35;1;11;19;8;3
15;35;1;27;20;22;5
16;35;1;2;2;0;2
16;35;1;1;3;0;1
16;35;1;2;4;0;2
16;35;1;5;5;0;5
16;35;1;10;6;0;10
16;35;1;9;7;0;9
16;35;1;8;8;0;8
16;35;1;13;9;0;13
16;35;1;14;10;2;12
16;35;1;6;11;1;5
16;35;1;12;12;3;9
16;35;1;17;13;2;15
16;35;1;19;14;5;14
16;35;1;18;15;2;16
16;35;1;16;16;5;11
16;35;1;9;17;0;9
16;35;1;9;18;0;9
16;35;1;12;19;1;11
16;35;1;15;20;2;13
17;35;1;6;1;6;0
17;35;1;5;2;5;0
17;35;1;6;3;6;0
17;35;1;4;4;3;1
17;35;1;2;5;2;0
17;35;1;11;6;11;0
17;35;1;9;7;9;0
17;35;1;9;8;8;1
17;35;1;8;9;4;4
17;35;1;10;10;9;1
17;35;1;14;11;13;1
17;35;1;14;12;14;0
17;35;1;10;13;5;5
17;35;1;21;14;21;0
17;35;1;24;15;21;3
17;35;1;17;16;16;1
17;35;1;15;17;15;0
17;35;1;22;18;22;0
17;35;1;22;19;20;2
17;35;1;12;20;10;2
18;35;1;1;1;1;0
18;35;1;3;2;3;0
18;35;1;3;3;3;0
18;35;1;2;4;2;0
18;35;1;2;5;2;0
18;35;1;5;6;5;0
18;35;1;5;7;5;0
18;35;1;6;8;6;0
18;35;1;4;9;4;0
18;35;1;17;10;17;0
18;35;1;10;11;10;0
18;35;1;11;12;11;0
18;35;1;21;13;20;1
18;35;1;18;14;18;0
18;35;1;11;15;11;0
18;35;1;23;16;23;0
18;35;1;11;17;11;0
18;35;1;6;18;6;0
18;35;1;12;20;11;1
19;35;1;2;3;2;0
19;35;1;1;4;1;0
19;35;1;6;5;6;0
19;35;1;3;6;3;0
19;35;1;3;7;3;0
19;35;1;4;8;4;0
19;35;1;7;9;7;0
19;35;1;3;10;3;0
19;35;1;2;11;1;1
19;35;1;2;12;1;1
19;35;1;10;13;10;0
19;35;1;8;14;7;1
19;35;1;8;15;8;0
19;35;1;1;16;0;1
19;35;1;13;17;12;1
19;35;1;8;18;8;0
19;35;1;23;19;22;1
19;35;1;46;20;45;1
20;35;1;1;5;1;0
20;35;1;6;6;6;0
20;35;1;3;7;3;0
20;35;1;3;8;3;0
20;35;1;5;9;5;0
20;35;1;5;11;5;0
20;35;1;5;12;5;0
20;35;1;7;13;7;0
20;35;1;15;14;15;0
20;35;1;23;15;23;0
20;35;1;18;16;18;0
20;35;1;11;17;11;0
20;35;1;7;18;7;0
20;35;1;15;19;15;0
20;35;1;16;20;16;0
21;35;1;10;2;10;0
21;35;1;6;3;6;0
21;35;1;16;4;15;1
21;35;1;27;5;25;2
21;35;1;20;6;20;0
21;35;1;17;7;17;0
21;35;1;15;8;15;0
21;35;1;15;9;15;0
21;35;1;24;10;24;0
21;35;1;16;11;16;0
21;35;1;17;12;17;0
21;35;1;19;13;19;0
21;35;1;17;14;17;0
21;35;1;11;15;11;0
21;35;1;9;16;9;0
21;35;1;6;17;6;0
21;35;1;9;18;9;0
21;35;1;9;19;9;0
21;35;1;17;20;17;0
22;35;1;1;2;1;0
22;35;1;3;3;3;0
22;35;1;2;4;2;0
22;35;1;3;5;2;1
22;35;1;10;6;10;0
22;35;1;7;7;7;0
22;35;1;7;8;5;2
22;35;1;6;9;5;1
22;35;1;7;10;4;3
22;35;1;7;11;6;1
22;35;1;10;12;8;2
22;35;1;10;13;8;2
22;35;1;14;14;13;1
22;35;1;11;15;8;3
22;35;1;14;16;13;1
22;35;1;17;17;13;4
22;35;1;11;18;10;1
22;35;1;23;19;19;4
22;35;1;24;20;17;7
23;35;1;3;6;3;0
23;35;1;6;7;6;0
23;35;1;7;8;6;1
23;35;1;8;9;8;0
23;35;1;8;10;7;1
23;35;1;5;11;4;1
23;35;1;15;12;13;2
23;35;1;12;13;9;3
23;35;1;17;14;17;0
23;35;1;20;15;20;0
23;35;1;10;16;9;1
23;35;1;22;17;21;1
23;35;1;24;18;24;0
23;35;1;21;19;20;1
23;35;1;25;20;25;0
24;35;1;1;1;0;1
24;35;1;4;2;4;0
24;35;1;6;3;6;0
24;35;1;4;4;3;1
24;35;1;6;5;2;4
24;35;1;11;6;9;2
24;35;1;11;7;11;0
24;35;1;10;8;10;0
24;35;1;14;9;7;7
24;35;1;12;10;11;1
24;35;1;14;11;14;0
24;35;1;12;12;12;0
24;35;1;15;13;13;2
24;35;1;3;14;3;0
24;35;1;6;15;6;0
24;35;1;8;16;7;1
24;35;1;9;17;7;2
24;35;1;12;18;12;0
24;35;1;19;19;12;7
24;35;1;23;20;14;9
25;35;1;1;2;1;0
25;35;1;2;3;2;0
25;35;1;1;5;1;0
25;35;1;1;6;1;0
25;35;1;2;7;2;0
25;35;1;4;8;4;0
25;35;1;1;9;1;0
25;35;1;7;10;7;0
25;35;1;4;11;4;0
25;35;1;6;12;4;2
25;35;1;2;13;2;0
25;35;1;9;14;9;0
25;35;1;4;15;3;1
25;35;1;12;16;12;0
25;35;1;22;17;21;1
25;35;1;6;18;6;0
25;35;1;16;19;15;1
25;35;1;16;20;14;2
26;35;1;2;3;2;0
26;35;1;4;5;4;0
26;35;1;7;6;7;0
26;35;1;5;7;5;0
26;35;1;8;8;8;0
26;35;1;7;9;7;0
26;35;1;13;10;13;0
26;35;1;4;11;4;0
26;35;1;3;12;3;0
26;35;1;1;14;0;1
26;35;1;4;16;4;0
26;35;1;1;17;1;0
26;35;1;5;18;5;0
26;35;1;2;19;2;0
26;35;1;12;20;12;0
27;35;1;2;3;2;0
27;35;1;2;5;2;0
27;35;1;4;6;4;0
27;35;1;8;7;8;0
27;35;1;9;8;9;0
27;35;1;1;9;1;0
27;35;1;4;10;4;0
27;35;1;5;11;5;0
27;35;1;6;12;6;0
27;35;1;11;13;11;0
27;35;1;10;14;10;0
27;35;1;10;15;10;0
27;35;1;17;16;17;0
27;35;1;15;17;15;0
27;35;1;8;18;7;1
27;35;1;11;19;9;2
27;35;1;10;20;9;1
28;35;1;1;3;0;1
28;35;1;3;4;2;1
28;35;1;5;5;5;0
28;35;1;7;6;5;2
28;35;1;9;7;7;2
28;35;1;16;8;16;0
28;35;1;4;9;4;0
28;35;1;5;10;4;1
28;35;1;7;11;7;0
28;35;1;9;12;7;2
28;35;1;11;13;4;7
28;35;1;11;14;10;1
28;35;1;4;15;2;2
28;35;1;5;16;2;3
28;35;1;5;17;4;1
28;35;1;9;18;4;5
28;35;1;6;19;4;2
28;35;1;17;20;7;10
29;35;1;1;4;1;0
29;35;1;3;5;3;0
29;35;1;3;6;3;0
29;35;1;7;7;7;0
29;35;1;10;9;10;0
29;35;1;17;10;15;2
29;35;1;15;11;15;0
29;35;1;16;12;15;1
29;35;1;20;13;20;0
29;35;1;14;14;14;0
29;35;1;29;15;29;0
29;35;1;15;16;10;5
29;35;1;17;17;15;2
29;35;1;20;18;16;4
29;35;1;5;19;2;3
29;35;1;23;20;19;4
30;35;1;2;4;2;0
30;35;1;10;5;10;0
30;35;1;7;6;5;2
30;35;1;7;7;5;2
30;35;1;4;8;4;0
30;35;1;7;9;6;1
30;35;1;5;10;2;3
30;35;1;3;11;1;2
30;35;1;11;12;6;5
30;35;1;8;13;6;2
30;35;1;17;14;11;6
30;35;1;9;15;7;2
30;35;1;14;16;13;1
30;35;1;16;17;14;2
30;35;1;15;18;11;4
30;35;1;16;19;14;2
30;35;1;22;20;19;3
31;35;1;3;4;3;0
31;35;1;7;5;7;0
31;35;1;4;6;4;0
31;35;1;13;7;13;0
31;35;1;6;8;5;1
31;35;1;7;9;7;0
31;35;1;8;10;7;1
31;35;1;10;11;9;1
31;35;1;12;12;12;0
31;35;1;17;13;16;1
31;35;1;21;14;21;0
31;35;1;16;15;15;1
31;35;1;13;16;13;0
31;35;1;8;17;8;0
31;35;1;11;18;10;1
31;35;1;13;19;13;0
31;35;1;2;20;2;0
32;35;1;2;6;1;1
32;35;1;2;7;1;1
32;35;1;6;8;5;1
32;35;1;8;9;8;0
32;35;1;5;10;5;0
32;35;1;6;11;6;0
32;35;1;4;12;3;1
32;35;1;8;13;6;2
32;35;1;15;14;14;1
32;35;1;10;15;10;0
32;35;1;18;16;16;2
32;35;1;8;17;8;0
32;35;1;11;18;10;1
32;35;1;9;19;4;5
32;35;1;10;20;7;3
33;35;1;1;6;1;0
33;35;1;1;7;1;0
33;35;1;1;8;1;0
33;35;1;1;9;1;0
33;35;1;1;10;1;0
33;35;1;4;12;4;0
33;35;1;1;13;1;0
33;35;1;7;15;7;0
33;35;1;1;18;1;0
34;35;1;1;1;0;1
34;35;1;1;2;0;1
34;35;1;4;3;4;0
34;35;1;5;4;4;1
34;35;1;5;5;4;1
34;35;1;3;6;2;1
34;35;1;9;7;5;4
34;35;1;12;8;6;6
34;35;1;10;9;5;5
34;35;1;11;10;5;6
34;35;1;9;11;6;3
34;35;1;7;12;4;3
34;35;1;20;13;10;10
34;35;1;8;14;2;6
34;35;1;20;15;10;10
34;35;1;11;16;5;6
34;35;1;20;17;9;11
34;35;1;19;18;12;7
34;35;1;10;19;5;5
34;35;1;1;20;1;0
35;35;1;2;2;2;0
35;35;1;2;3;2;0
35;35;1;1;4;1;0
35;35;1;4;5;4;0
35;35;1;3;6;3;0
35;35;1;7;7;6;1
35;35;1;6;8;5;1
35;35;1;2;9;2;0
35;35;1;4;10;3;1
35;35;1;4;11;4;0
35;35;1;2;12;2;0
35;35;1;9;13;9;0
35;35;1;4;14;4;0
35;35;1;15;15;15;0
35;35;1;8;16;8;0
35;35;1;15;17;15;0
35;35;1;13;18;13;0
35;35;1;8;19;8;0
35;35;1;18;20;18;0
36;35;1;2;2;2;0
36;35;1;2;3;2;0
36;35;1;3;4;3;0
36;35;1;2;5;2;0
36;35;1;2;6;2;0
36;35;1;5;7;5;0
36;35;1;11;8;11;0
36;35;1;21;9;21;0
36;35;1;20;10;20;0
36;35;1;24;11;24;0
36;35;1;19;12;19;0
36;35;1;30;13;30;0
36;35;1;34;14;34;0
36;35;1;28;15;28;0
36;35;1;27;16;27;0
36;35;1;31;17;31;0
36;35;1;12;18;12;0
36;35;1;20;19;20;0
36;35;1;12;20;12;0
37;35;1;4;3;0;4
37;35;1;7;4;7;0
37;35;1;9;5;9;0
37;35;1;5;6;5;0
37;35;1;6;7;5;1
37;35;1;7;8;5;2
37;35;1;2;9;2;0
37;35;1;9;10;8;1
37;35;1;4;11;2;2
37;35;1;3;12;1;2
37;35;1;9;13;6;3
37;35;1;5;14;4;1
37;35;1;13;15;7;6
37;35;1;13;16;12;1
37;35;1;13;17;11;2
37;35;1;18;18;15;3
37;35;1;8;19;7;1
37;35;1;44;20;38;6
38;35;1;10;1;10;0
38;35;1;4;2;4;0
38;35;1;3;3;3;0
38;35;1;3;4;3;0
38;35;1;4;5;4;0
38;35;1;5;6;5;0
38;35;1;8;7;8;0
38;35;1;10;8;10;0
38;35;1;7;9;7;0
38;35;1;22;10;22;0
38;35;1;10;11;10;0
38;35;1;21;12;21;0
38;35;1;23;13;23;0
38;35;1;11;14;11;0
38;35;1;2;15;2;0
38;35;1;1;16;1;0
38;35;1;5;17;5;0
38;35;1;5;18;5;0
38;35;1;12;19;12;0
38;35;1;10;20;10;0
39;35;1;1;3;1;0
39;35;1;1;4;1;0
39;35;1;9;8;9;0
39;35;1;9;9;8;1
39;35;1;22;10;22;0
39;35;1;7;11;6;1
39;35;1;18;12;18;0
39;35;1;19;13;19;0
39;35;1;17;14;15;2
39;35;1;13;15;13;0
39;35;1;17;16;16;1
39;35;1;35;17;34;1
39;35;1;43;18;42;1
39;35;1;42;19;40;2
39;35;1;28;20;27;1
40;35;1;2;2;2;0
40;35;1;1;3;1;0
40;35;1;2;4;2;0
40;35;1;2;5;1;1
40;35;1;1;6;1;0
40;35;1;5;7;5;0
40;35;1;1;8;1;0
40;35;1;7;9;7;0
40;35;1;10;10;10;0
40;35;1;17;11;17;0
40;35;1;15;12;15;0
40;35;1;14;13;14;0
40;35;1;16;14;16;0
40;35;1;12;15;12;0
40;35;1;7;16;7;0
40;35;1;10;17;10;0
40;35;1;9;18;9;0
40;35;1;14;19;14;0
40;35;1;30;20;30;0
41;35;1;1;4;1;0
41;35;1;1;6;1;0
41;35;1;1;7;1;0
41;35;1;1;11;1;0
41;35;1;1;14;1;0
41;35;1;2;15;2;0
41;35;1;1;16;1;0
41;35;1;7;17;7;0
41;35;1;1;18;1;0
41;35;1;1;19;1;0
41;35;1;7;20;7;0
43;35;1;2;4;2;0
43;35;1;1;5;1;0
43;35;1;1;7;1;0
43;35;1;1;8;1;0
43;35;1;7;10;7;0
43;35;1;5;11;5;0
43;35;1;7;12;7;0
43;35;1;8;13;8;0
43;35;1;8;14;8;0
43;35;1;7;15;7;0
43;35;1;3;16;3;0
43;35;1;8;17;8;0
43;35;1;6;18;6;0
43;35;1;11;19;9;2
44;35;1;5;1;5;0
44;35;1;5;2;5;0
44;35;1;7;3;7;0
44;35;1;8;4;8;0
44;35;1;12;5;12;0
44;35;1;13;6;13;0
44;35;1;19;7;19;0
44;35;1;16;8;16;0
44;35;1;20;9;20;0
44;35;1;8;10;8;0
44;35;1;5;11;5;0
44;35;1;9;12;9;0
44;35;1;16;13;16;0
44;35;1;10;14;10;0
44;35;1;15;15;15;0
44;35;1;8;16;8;0
44;35;1;16;17;16;0
44;35;1;13;18;13;0
44;35;1;13;19;13;0
44;35;1;5;20;5;0
